## ######
##      #
####### #
#       #
# ##### #
# ##### #
#     # #
####### #
