##################################### ##########################
# #        ##    # #    ##  ###  #    ## ##  #            #    #
#   ## ###  #### # ## #  ##  #  ### #  # #  ### ### ##### ## # #
# #  #   ##  ##  # #  ##  # ## ## # ##     #### ##   # #     # #
#### # ##### #  ##   #### #  # #     #####   #   ## ## # ### # #
#    ### #   # ##  ### #  # ##   ###### ## ### ###     #  #### #
# # ##   ### # ## ##   # ##    # #       ###   ##  ######    ###
# ###  #   # #  # #  ### #### ## # #####  ######  ##  #   ##   #
#  ## #### ####   # ###   #    #   #   ##  #   ## ## ## ###### #
## #     #   ### ## #   # #### #######  ##   #  ###   # #   #  #
## # ##### # # ###    ### ##   # # ##  ##  # ## ##  # ### #   ##
#    # #   # # ##  ####    ###   #    ######### #  ##  #  # #  #
####   ### #   #  ## #  ##   ###   # ##   ## #  # ###### ## ## #
## ###  #  # # ## #  ## ### ## # #####  #      ## #  #    ###  #
#    ## #### #  #   ##    # #     #    ##### # #    ## ##   ## #
# ##  #   ##### ###  #### #### ##### ###   # ### ## ##  # #  ###
#  ## ## ## # #  #  ## #  #    # # #  #  # # ##  #   #### ##   #
## #  #   #   # ### #  # ### ###   ##   ## #  ######       # # #
#  # ## #   # # #     ##   ###   #  # #  # ##    # ##### ##### #
# ## ##### #### # ########   ## ## ## # ##  #### #     ###   # #
# #    #    ##  # #      # #  #### ## #  ####    #####     #   #
# #### ####  # #### ## #   ##### #  #### #  ## #### ## ##### ###
# ##      ## # # ##  #####  ##   ##  #     ##   ##   #  #  ### #
#  ## ###  ### #  # ##   ####  #  ##   #####  ###  #   ###     #
##  #   ##     # ##  ###  ##  ## ### ###     ## ## ## ##   # # #
### ###  ##### #  ## # ##  # ##    ####  ###  #     #  # ### ###
#    #####  ##### #  #  ## #  ####  ##  ## ## ##### ## #  #  # #
####    ###  ## # ## # ##  # ##  # ##  ##  ##   # ###  # ###   #
# #####   ##      ##    # ##  ##      ##  ##  # # ##  ##   ### #
# #     #  ### # ##  # ##  ##  ######  ## #  ## #    ##  ###   #
#   ## ## ##   #    ####  ####      ##    ####  # ######## ## ##
# ######  #  # ## ####   ### ########## ### #  ## #    ##      #
#  # ##  ### #  # ##   #   #          ###     ### ## #  # ######
##   #  ###  ####  ## ### ## # #### #   ##### # # #  ##   # ## #
### ## ## ##  ##  ##  #   ####    #### ##     # #   ##### #    #
# ###        ##  ##  ## #   #  ## ##    ### # #   # # # #### # #
#  #  ######  ####  ### ## ## #####  ##  ## #   ##### #    # ###
# ###  #  ###   ## ## # #  #  #     ####    ###  #    ### ##   #
#   ##   ## ###     #   ##   ###### ## ### ## ## ####  #   ## ##
## #####  #   ######## ##### # ## ###   #  ##    #    ## ####  #
#      ## # ###    ##  #  ####    ##  ######  ##   ####    #  ##
# # # ##  #     # ##  ###    ## #    ## # ### ####   ##### # ###
# ###  # ### ####  ## # # ##    # ##  #    ##   #  ###         #
#  ## ## #   #  ##  #   # ## ## #  #######  ### ##   #### ## # #
# ##   #   ####  # ## #####  ## ##  #   ###   # #  #    # #### #
###  ######## ##    #  # #  ##   #### #  ## ### ##### #   #  # #
##  ###   #   ## ## ## #   ##  ####   ##  #       # ### ####   #
#  ##   ### #  ###   #   ###  ##    # ###   ## ####   #### ## ##
# #### ##   ## #   # #####   #### ###  #  #  #  # ###   #   #  #
# #    ## ###### #####   ##### #  #   ## ### ##    ####   # ## #
#   ##         # #  ####    #    ######### ###  ##   #  # # ## #
# ###  # #####   # ##  # # ## #####    ##  ##  ##### # ## ###  #
# #   ####   #####    ####    #   ## #  # ##  ##   # ###  #   ##
# ###  #   #    ### ### ## #### #    ## #    ### #   #   ## ####
#  ### # ######      #  #  #    ######  ### ## ####### ###   # #
##  ## #      #### # ## ## # ##  # #   ###  #  # ##      ### # #
#####  ##### ##  # ###   ### ## ##   # ##  ## ##    ### ##     #
# #   ##   #  ## #  ## #  #   ###  ### #  ##   # #### #    #####
# ## ##### ## #  ##    ##   ###   ###  # ### #   ## # ## ###  ##
# ##   ##  ## # ###########  ### ##   ## ##  # ###     ### ##  #
#    #  # ##  #  # #      ##  #   # #    #  ## #   ##### # ### #
####### #  ## ##   # ### #### ## ######### ##    #  ## #   # # #
#         ##     #   #   #    #    #       #  # ###      #     #
########################## #####################################
