#############
#           #
#  #######  #
        #   #
#  #######   
#        #  #
#############

