#############
#           #
# ######### #
        #   #
# #########  
#         # #
#############

