### ###########
#     #       #
# ### # # ### #
#       #     #
############# #
#     #       #
# ### # # ### #
#       #     #
### ###########
#     #       #
# ### # # ### #
#       #     #
############# #
#     #       #
# ### # # ### #
#       #     #
####### #######
