### #############
#     #       # #
# ### # # ### ###
#       #     ###
############# ###
############# ###
#     #       # #
# ### # # ### ###
#       #     ###
### #############
### #############
#     #       # #
# ### # # ### ###
#       #     ###
############# ###
############# ###
#     #       # #
# ### # # ### ###
#       #     ###
####### #########
